+++++++++++++++++++++++++++
+     +       +           +
+ ++ ++ +++++ + +++ + +++++
+       +     + + + + +   +
* + + +++ +++++ + + +++ + +
+ + +   + +   +   +     + +
+ + +++ + + + +++++  ++++ +
+ +     +   +     +       +
+ ++++ ++++++++++ + +++++++
+       +   +   + +   +   +
+++++++ + + +++ + +++ + + +
+     +   + +   +   +   + +
+ +++++++++ + +++++ + +++ +
+ +         +   +   +   + +
+ + + + + +++++ + +++++ + +
+ + + + +   +   + +     + +
+ + + +++++ + + + +++++++ +
+ + +       + + +T  +     +
+ + +++++++++ + + + + +++ +
+             +   +   +   +
+++++++++++++++++++++++++++
